1111111
1P000C1
1001111
10010E1
1111111