11111111111111111111
1C00001000C00X000001
10000010011110C00111
1001C00001C010000001
11010000010000000111
10000011000111000011
1P0110110000000000C1
10000011C00001100001
100001111100011110E1
11111111111111111111