11111111111111111111
1C00001000C000000001
1000001001111XC00111
1001C00001C0100000C1
11010000010010011111
10000011000111000011
1P0110110000000000C1
10000011C00000100001
100001111100001110E1
11111111111111111111