11111
1P1C1
101X1
10001
101E1
11111
