11111111111111111111
1C00001000C00X000001
10000P10011110C00111
1001C00001C010000001
1101000C0100000C00E1
11111111111111111111