11111111111111111
1P0000C0000C00C01
11111111111111101
100C0000C0000C001
10111111111111111
1C0000000C000C001
11111111111111101
1C00CC000C000C0X1
1E111110001111101
11111111111111111