11111111111111111111
1P000000000C00000C01
11111111111111111101
100C000000C00000C001
10111111111111111111
1C0000000000C000C001
11111111111111111101
1C0000000000C000C0X1
1E111111111111111101
11111111111111111111