11111111111111111111
1C00000000C000000001
10011111111111111111
1000C00000C0000000C1
11011111111111111001
1000001100X111000011
1P0110110000000000C1
11111111C00000111111
100001111100000000E1
11111111111111111111