1111111
1PXCC01
1101101
100C001
1C011E1
1111111