1111111
1PXCC01
11011E1
1111111