1111111
1PXCC01
1101101
10000E1
1111111